PPPPPPPPPPPPP
P           P
P     @     P
P           P
P           P
P    A      P
P           P
P           P
P      T    P
P           P
PPPPPPPPPPPPP