PPPPPPPPPPPPP
PPPPP   B  PP
PPC P @ PPPPP
P        pppp
P           p
P     T     P
PPBP E E    P
PP PP   PPBPP
P   B   PP PP
PPCPP   PP PP
PPPPPPPPPPPPP