PPPPPPPPPPPPP
PCP   T     P
P    E E    P
P     E   PPP
P    E E  B P
PAAA  E  ACAP
P         PPP
PPP       PPP
PCCB     BCCP
P  B  @  B  P
PPPPPPPPPPPPP