PPPPPPPPPPPPP
PTCC        P
PAAAAAAAAAA P
P      P E  P
P           P
PPPPPPBPPPPPP
PB B BEB B BP
P B B B B B P
PB B B B B BP
P     @     P
PPPPPPPPPPPPP