PPPPPPPPPPPPP
PPPPP   B  PP
PP  P @ PCPPP
P        PPPP
P           P
P     T     P
PPBP E E    P
PP PP   PPBPP
P   B   PP CP
PPPPP   PP PP
PPPPPPPPPPPPP